000000000000000000000000000000000000000000000000000000000000000000000000000000000000000000000000000000000000000000000000000000000000000000000000
000000000000000000000000000000000000000000000000000000000000000000000000000000000000000000000000000000000000000000000000000000000000000000000000
000000000000000000000000000000000000000111111110001111111111111100000000000000000000000000000000000000000000000000000000000000000000000000000000
000000000000000000000000000000000111111111111111111111111111111110000000000001110000000000000000000000000000001000000000000000000000000000000000
000000000000000000000000000000001111111111111111111111111111111111000000000000111000000000000000000000000000011111000000000000000000000000000000
000000000000000000000000111100011111111110001111111111111111111110000000000000000000000000000000000000000001111111110000000000000000000000000000
000000000000000000000001111111111111111111000000011111111111111100000000000000000000000000000000111111111111111111111111111111111111000000000000
000000001100011100000011111111111111111111110000001111111111111100000000000000001111000000000001111111111111111111111111111111111111111000000000
110000011111111111111111111111111111111111111100001111111111110000000000000000111111111100001111111111111111111111111111111111111111111111111111
111000111111111111111111111111111111111100111100001111111110001110000000000011111111111111111111111111111111111111111111111111111111111111111111
111001111111111111111111111111111111110001111100000111111000000111000000001111111111111111111111111111111111111111111111111111111111111111111111
000001111111111111111111111111111110000011111000000011100000000000000000001111111111111111111111111111111111111111111111111111111111111111111110
000000111111100011111111111111111111000001111110000000000000000000000000001111101111111111111111111111111111111111111111111111111100001111111000
000000001100000000111111111111111111110001111111000000000000000000001110000111101111111111111111111111111111111111111111111111111000001111000000
000000000000000000001111111111111111111111111111110000000000000000001111100111111111111111111111111111111111111111111111111111111000001110000000
000000000000000000000111111111111111111111111111110000000000000000000111111111111111111111111111111111111111111111111111111111111000000100000000
000000000000000000000111111111111111111111111111111000000000000000000011111111111111111111111111111111111111111111111111111111111000000000000000
000000000000000000000011111111111111111111111100100000000000000000000001111111111111111111111111111111111111111111111111111111111000000000000000
000000000000000000000011111111111111111111111000000000000000000000001111111111111111001111111111111111111111111111111111111110000000000000000000
000000000000000000000011111111111111111111111000000000000000000000001111100011111111111111111111111111111111111111111111111100000000000000000000
000000000000000000000011111111111111111111100000000000000000000000001111100000001111111111111111111111111111111111111111111000010000000000000000
000000000000000000000001111111111111111111000000000000000000000000000111111110000000111111111111111111111111111111111111111001110000000000000000
000000000000000000000000111111111111111110000000000000000000000000001111111111000000001111111111111111111111111111111111111000111000000000000000
000000000000000000000000011111111111111100000000000000000000000000001111111111111111111111111111111111111111111111111111100000000000000000000000
000000000000000000000000001111111100011100000000000000000000000000111111111111111111111111111111111111111111111111111111100000000000000000000000
000000000000000000000000000111111100000000000000000000000000000001111111111111111111111111111111111111111111111111111111000000000000000000000000
000000000000000000000000000001111100000000000000000000000000000001111111111111111111111111111111111111111111111111111110000000000000000000000000
000000000000000000000000000001111111000001100000000000000000000001111111111111111111111111111110000011111111111111110000000000000000000000000000
000000000000000000000000000000111111100000100000000000000000000001111111111111111111111111111111000001111111111111110000000000000000000000000000
000000000000000000000000000000011111110000000000000000000000000001111111111111111111111111111100000001111000001111110001110000000000000000000000
000000000000000000000000000000000001110000000000000000000000000001111111111111111111111111100000000001111000000111110000110000000000000000000000
000000000000000000000000000000000000111001111110000000000000000001111111111111111111111111110000000000111000000111110000111000000000000000000000
000000000000000000000000000000000000011111111111100000000000000000111111111111111111111111111000000000011000000111100000011100000000000000000000
000000000000000000000000000000000000000011111111111000000000000000011111111111111111111111110000000000000000001111101110000000000000000000000000
000000000000000000000000000000000000000011111111111100000000000000000111111111111111111111110000000000000000001111111111000000000000000000000000
000000000000000000000000000000000000000011111111111110000000000000000000000111111111111111100000000000000000000111111111100000000000000000000000
000000000000000000000000000000000000000111111111111111100000000000000000000111111111111110000000000000000000000111111111100011110000000000000000
000000000000000000000000000000000000000111111111111111111000000000000000000011111111111110000000000000000000000011111111000000111110000000000000
000000000000000000000000000000000000000111111111111111111100000000000000000011111111111110000000000000000000000001111110000000111110000000000000
000000000000000000000000000000000000000011111111111111111100000000000000000011111111111110000000000000000000000000011110000000111110000000000000
000000000000000000000000000000000000000001111111111111111100000000000000000011111111111110000000000000000000000000000000000011111110000000000000
000000000000000000000000000000000000000001111111111111111000000000000000000011111111111100010000000000000000000000000000001111111100000000000000
000000000000000000000000000000000000000000111111111111111000000000000000000011111111111100011000000000000000000000000000011111111100000000000000
000000000000000000000000000000000000000000011111111111111000000000000000000011111111111001111000000000000000000000000001111111111110000000000000
000000000000000000000000000000000000000000011111111111111000000000000000000011111111111001111000000000000000000000000011111111111111000000000000
000000000000000000000000000000000000000000011111111111100000000000000000000001111111110001110000000000000000000000000111111111111111100000000000
000000000000000000000000000000000000000000011111111111000000000000000000000001111111110000100000000000000000000000001111111111111111100000000000
000000000000000000000000000000000000000000011111111110000000000000000000000000111111110000000000000000000000000000000111111111111111100000000000
000000000000000000000000000000000000000000011111111100000000000000000000000000111111100000000000000000000000000000000111111111111111100000000000
000000000000000000000000000000000000000000011111111000000000000000000000000000001111000000000000000000000000000000000001111111111111100000000000
000000000000000000000000000000000000000000111111110000000000000000000000000000000000000000000000000000000000000000000000000000011111100000000010
000000000000000000000000000000000000000000111111100000000000000000000000000000000000000000000000000000000000000000000000000000001111000000000111
000000000000000000000000000000000000000000111111000000000000000000000000000000000000000000000000000000000000000000000000000000000011000000001111
000000000000000000000000000000000000000000111110000000000000000000000000000000000000000000000000000000000000000000000000000000000000000000001100
000000000000000000000000000000000000000000111100000000000000000000000000000000000000000000000000000000000000000000000000000000000000000000010000
000000000000000000000000000000000000000000111100000000000000000000000000000000000000000000000000000000000000000000000000000000000000000000000000
000000000000000000000000000000000000000000111100000000000000000000000000000000000000000000000000000000000000000000000000000000000000000000000000
000000000000000000000000000000000000000000111000000000000000000000000000000000000000000000000000000000000000000000000000000000000000000000000000
000000000000000000000000000000000000000000000000000000000000000000000000000000000000000000000000000000000000000000000000000000000000000000000000
000000000000000000000000000000000000000000000000000000000000000000000000000000000000000000000000000000000000000000000000000000000000000000000000
000000000000000000000000000000000000000000000000000000000000000000000000000000000000000000000000000000000000000000000000000000000000000000000000
000000000000000000000000000000000000000000000001100000000000000000000000000000000000000000000000000000000000000000000000000000000000000000000000
000000000000000000000000000000000000000000000010100000000000000000000000000000000000000000111110000000000111111111111111111111111100000000000000
000000000000000000000000000000000000000000001110000000000000000000000000000000000000000111111111111000111111111111111111111111111111110000000000
000000000000000000000000000000010000000000111111000000000000000000111111111111111111111111111111111111111111111111111111111111111111111111110000
000000000000000111111111111111111111111111111111000000000000000001111111111111111111111111111111111111111111111111111111111111111111111111110000
000000000000111111111111111111111111111111111110000000000000111111111111111111111111111111111111111111111111111111111111111111111111111111100000
111111111111111111111111111111111111111111111111111111111111111111111111111111111111111111111111111111111111111111111111111111111111111111111111
111111111111111111111111111111111111111111111111111111111111111111111111111111111111111111111111111111111111111111111111111111111111111111111111
111111111111111111111111111111111111111111111111111111111111111111111111111111111111111111111111111111111111111111111111111111111111111111111111
111111111111111111111111111111111111111111111111111111111111111111111111111111111111111111111111111111111111111111111111111111111111111111111111
111111111111111111111111111111111111111111111111111111111111111111111111111111111111111111111111111111111111111111111111111111111111111111111111
